.............................
.............................
..bb..bb..bb..bb..bb..bb.....
..bb..bb..bb..bb..bb..bb.....
..bb..bb..bb..bb..bb..bb.....
..bb..bb..bb..bb..bb..bb.....
..bb..bb..bbccbb..bb..bb.....
..bb..bb..bbccbb..bb..bb.....
..bb..bb..bb..bb..bb..bb.....
..bb..bb..........bb..bb.....
..bb..bb..........bb..bb.....
..........bb..bb.............
..........bb..bb.............
....bbbb..........bbbb.......
cc..bbbb..........bbbb..cc...
..........bb..bb.............
..........bbbbbb.............
..bb..bb..bbbbbb..bb..bb.....
..bb..bb..bb..bb..bb..bb.....
..bb..bb..bb..bb..bb..bb.....
..bb..bb..bb..bb..bb..bb.....
..bb..bb..........bb..bb.....
..bb..bb..........bb..bb.....
..bb..bb...bbbb...bb..bb.....
...........bf.b..............
...........b..b..............