.............................
...........................ee
..bb..bb..bb..bb..bb..bb...ee
..bb..bb..bb..bb..bb..bb...ee
..bb..bb..bb..bb..bb..bb...ee
..bb..bb..bb..bb..bb..bb...ee
..bb..bb..bbccbb..bb..bb...ee
..bb..bb..bbccbb..bb..bb...ee
..bb..bb..bb..bb..bb..bb...ee
..bb..bb..........bb..bb...ee
..bb..bb..........bb..bb...ee
..........bb..bb.............
..........bb..bb...........a.
....bbbb..........bbbb.......
cc..bbbb..........bbbb..cc.g.
..........bb..bb.............
..........bbbbbb.............
..bb..bb..bbbbbb..bb..bb.....
..bb..bb..bb..bb..bb..bb.....
..bb..bb..bb..bb..bb..bb.....
..bb..bb..bb..bb..bb..bb.....
..bb..bb..........bb..bb.....
..bb..bb..........bb..bb.....
..bb..bb...bbbb...bb..bb.....
...........bf.b..............
...........b..b..............